Revelation 18:8	Therefore shall her plagues come in one day, death, and mourning, and famine; and she shall be utterly burned with fire: for strong is the Lord God who judgeth her.
Revelation 18:9	And the kings of the earth, who have committed fornication and lived deliciously with her, shall bewail her, and lament for her, when they shall see the smoke of her burning,
Revelation 18:10	Standing afar off for the fear of her torment, saying, Alas, alas that great city Babylon, that mighty city! for in one hour is thy judgment come.
Revelation 18:11	And the merchants of the earth shall weep and mourn over her; for no man buyeth their merchandise any more:
Revelation 18:12	The merchandise of gold, and silver, and precious stones, and of pearls, and fine linen, and purple, and silk, and scarlet, and all thyine wood, and all manner vessels of ivory, and all manner vessels of most precious wood, and of brass, and iron, and marble,
Revelation 18:13	And cinnamon, and odours, and ointments, and frankincense, and wine, and oil, and fine flour, and wheat, and beasts, and sheep, and horses, and chariots, and slaves, and souls of men.
Revelation 18:14	And the fruits that thy soul lusted after are departed from thee, and all things which were dainty and goodly are departed from thee, and thou shalt find them no more at all.
Revelation 18:15	The merchants of these things, which were made rich by her, shall stand afar off for the fear of her torment, weeping and wailing,
Revelation 18:16	And saying, Alas, alas that great city, that was clothed in fine linen, and purple, and scarlet, and decked with gold, and precious stones, and pearls!
Revelation 18:17	For in one hour so great riches is come to nought. And every shipmaster, and all the company in ships, and sailors, and as many as trade by sea, stood afar off,
Revelation 18:18	And cried when they saw the smoke of her burning, saying, What city is like unto this great city!
Revelation 18:19	And they cast dust on their heads, and cried, weeping and wailing, saying, Alas, alas that great city, wherein were made rich all that had ships in the sea by reason of her costliness! for in one hour is she made desolate.
Revelation 18:20	Rejoice over her, thou heaven, and ye holy apostles and prophets; for God hath avenged you on her.
Revelation 18:21	And a mighty angel took up a stone like a great millstone, and cast it into the sea, saying, Thus with violence shall that great city Babylon be thrown down, and shall be found no more at all.
Revelation 18:22	And the voice of harpers, and musicians, and of pipers, and trumpeters, shall be heard no more at all in thee; and no craftsman, of whatsoever craft he be, shall be found any more in thee; and the sound of a millstone shall be heard no more at all in thee;
Revelation 18:23	And the light of a candle shall shine no more at all in thee; and the voice of the bridegroom and of the bride shall be heard no more at all in thee: for thy merchants were the great men of the earth; for by thy sorceries were all nations deceived.
Revelation 18:24	And in her was found the blood of prophets, and of saints, and of all that were slain upon the earth.
Revelation 19:1	And after these things I heard a great voice of much people in heaven, saying, Alleluia; Salvation, and glory, and honour, and power, unto the Lord our God:
Revelation 19:2	For true and righteous are his judgments: for he hath judged the great whore, which did corrupt the earth with her fornication, and hath avenged the blood of his servants at her hand.
Revelation 19:3	And again they said, Alleluia And her smoke rose up for ever and ever.
Revelation 19:4	And the four and twenty elders and the four beasts fell down and worshipped God that sat on the throne, saying, Amen; Alleluia.
Revelation 19:5	And a voice came out of the throne, saying, Praise our God, all ye his servants, and ye that fear him, both small and great.
Revelation 19:6	And I heard as it were the voice of a great multitude, and as the voice of many waters, and as the voice of mighty thunderings, saying, Alleluia: for the Lord God omnipotent reigneth.
Revelation 19:7	Let us be glad and rejoice, and give honour to him: for the marriage of the Lamb is come, and his wife hath made herself ready.
Revelation 19:8	And to her was granted that she should be arrayed in fine linen, clean and white: for the fine linen is the righteousness of saints.
Revelation 19:9	And he saith unto me, Write, Blessed are they which are called unto the marriage supper of the Lamb. And he saith unto me, These are the true sayings of God.
Revelation 19:10	And I fell at his feet to worship him. And he said unto me, See thou do it not: I am thy fellowservant, and of thy brethren that have the testimony of Jesus: worship God: for the testimony of Jesus is the spirit of prophecy.
Revelation 19:11	And I saw heaven opened, and behold a white horse; and he that sat upon him was called Faithful and True, and in righteousness he doth judge and make war.
Revelation 19:12	His eyes were as a flame of fire, and on his head were many crowns; and he had a name written, that no man knew, but he himself.
Revelation 19:13	And he was clothed with a vesture dipped in blood: and his name is called The Word of God.
Revelation 19:14	And the armies which were in heaven followed him upon white horses, clothed in fine linen, white and clean.
Revelation 19:15	And out of his mouth goeth a sharp sword, that with it he should smite the nations: and he shall rule them with a rod of iron: and he treadeth the winepress of the fierceness and wrath of Almighty God.
Revelation 19:16	And he hath on his vesture and on his thigh a name written, KING OF KINGS, AND LORD OF LORDS.
Revelation 19:17	And I saw an angel standing in the sun; and he cried with a loud voice, saying to all the fowls that fly in the midst of heaven, Come and gather yourselves together unto the supper of the great God;
Revelation 19:18	That ye may eat the flesh of kings, and the flesh of captains, and the flesh of mighty men, and the flesh of horses, and of them that sit on them, and the flesh of all men, both free and bond, both small and great.
Revelation 19:19	And I saw the beast, and the kings of the earth, and their armies, gathered together to make war against him that sat on the horse, and against his army.
Revelation 19:20	And the beast was taken, and with him the false prophet that wrought miracles before him, with which he deceived them that had received the mark of the beast, and them that worshipped his image. These both were cast alive into a lake of fire burning with brimstone.
Revelation 19:21	And the remnant were slain with the sword of him that sat upon the horse, which sword proceeded out of his mouth: and all the fowls were filled with their flesh.
Revelation 20:1	And I saw an angel come down from heaven, having the key of the bottomless pit and a great chain in his hand.
Revelation 20:2	And he laid hold on the dragon, that old serpent, which is the Devil, and Satan, and bound him a thousand years,
Revelation 20:3	And cast him into the bottomless pit, and shut him up, and set a seal upon him, that he should deceive the nations no more, till the thousand years should be fulfilled: and after that he must be loosed a little season.
Revelation 20:4	And I saw thrones, and they sat upon them, and judgment was given unto them: and I saw the souls of them that were beheaded for the witness of Jesus, and for the word of God, and which had not worshipped the beast, neither his image, neither had received his mark upon their foreheads, or in their hands; and they lived and reigned with Christ a thousand years.
Revelation 20:5	But the rest of the dead lived not again until the thousand years were finished. This is the first resurrection.
Revelation 20:6	Blessed and holy is he that hath part in the first resurrection: on such the second death hath no power, but they shall be priests of God and of Christ, and shall reign with him a thousand years.
Revelation 20:7	And when the thousand years are expired, Satan shall be loosed out of his prison,
Revelation 20:8	And shall go out to deceive the nations which are in the four quarters of the earth, Gog, and Magog, to gather them together to battle: the number of whom is as the sand of the sea.
Revelation 20:9	And they went up on the breadth of the earth, and compassed the camp of the saints about, and the beloved city: and fire came down from God out of heaven, and devoured them.
Revelation 20:10	And the devil that deceived them was cast into the lake of fire and brimstone, where the beast and the false prophet are, and shall be tormented day and night for ever and ever.
Revelation 20:11	And I saw a great white throne, and him that sat on it, from whose face the earth and the heaven fled away; and there was found no place for them.
Revelation 20:12	And I saw the dead, small and great, stand before God; and the books were opened: and another book was opened, which is the book of life: and the dead were judged out of those things which were written in the books, according to their works.
