Jeremiah 6:12	And their houses shall be turned unto others, with their fields and wives together: for I will stretch out my hand upon the inhabitants of the land, saith the LORD.
Jeremiah 6:13	For from the least of them even unto the greatest of them every one is given to covetousness; and from the prophet even unto the priest every one dealeth falsely.
Jeremiah 6:14	They have healed also the hurt of the daughter of my people slightly, saying, Peace, peace; when there is no peace.
Jeremiah 6:15	Were they ashamed when they had committed abomination? nay, they were not at all ashamed, neither could they blush: therefore they shall fall among them that fall: at the time that I visit them they shall be cast down, saith the LORD.
Jeremiah 6:16	Thus saith the LORD, Stand ye in the ways, and see, and ask for the old paths, where is the good way, and walk therein, and ye shall find rest for your souls. But they said, We will not walk therein.
Jeremiah 6:17	Also I set watchmen over you, saying, Hearken to the sound of the trumpet. But they said, We will not hearken.
Jeremiah 6:18	Therefore hear, ye nations, and know, O congregation, what is among them.
Jeremiah 6:19	Hear, O earth: behold, I will bring evil upon this people, even the fruit of their thoughts, because they have not hearkened unto my words, nor to my law, but rejected it.
Jeremiah 6:20	To what purpose cometh there to me incense from Sheba, and the sweet cane from a far country? your burnt offerings are not acceptable, nor your sacrifices sweet unto me.
Jeremiah 6:21	Therefore thus saith the LORD, Behold, I will lay stumblingblocks before this people, and the fathers and the sons together shall fall upon them; the neighbour and his friend shall perish.
Jeremiah 6:22	Thus saith the LORD, Behold, a people cometh from the north country, and a great nation shall be raised from the sides of the earth.
Jeremiah 6:23	They shall lay hold on bow and spear; they are cruel, and have no mercy; their voice roareth like the sea; and they ride upon horses, set in array as men for war against thee, O daughter of Zion.
Jeremiah 6:24	We have heard the fame thereof: our hands wax feeble: anguish hath taken hold of us, and pain, as of a woman in travail.
Jeremiah 6:25	Go not forth into the field, nor walk by the way; for the sword of the enemy and fear is on every side.
Jeremiah 6:26	O daughter of my people, gird thee with sackcloth, and wallow thyself in ashes: make thee mourning, as for an only son, most bitter lamentation: for the spoiler shall suddenly come upon us.
Jeremiah 6:27	I have set thee for a tower and a fortress among my people, that thou mayest know and try their way.
Jeremiah 6:28	They are all grievous revolters, walking with slanders: they are brass and iron; they are all corrupters.
Jeremiah 6:29	The bellows are burned, the lead is consumed of the fire; the founder melteth in vain: for the wicked are not plucked away.
Jeremiah 6:30	Reprobate silver shall men call them, because the LORD hath rejected them.
Jeremiah 7:1	The word that came to Jeremiah from the LORD, saying,
Jeremiah 7:2	Stand in the gate of the LORD's house, and proclaim there this word, and say, Hear the word of the LORD, all ye of Judah, that enter in at these gates to worship the LORD.
Jeremiah 7:3	Thus saith the LORD of hosts, the God of Israel, Amend your ways and your doings, and I will cause you to dwell in this place.
Jeremiah 7:4	Trust ye not in lying words, saying, The temple of the LORD, The temple of the LORD, The temple of the LORD, are these.
Jeremiah 7:5	For if ye throughly amend your ways and your doings; if ye throughly execute judgment between a man and his neighbour;
Jeremiah 7:6	If ye oppress not the stranger, the fatherless, and the widow, and shed not innocent blood in this place, neither walk after other gods to your hurt:
Jeremiah 7:7	Then will I cause you to dwell in this place, in the land that I gave to your fathers, for ever and ever.
Jeremiah 7:8	Behold, ye trust in lying words, that cannot profit.
Jeremiah 7:9	Will ye steal, murder, and commit adultery, and swear falsely, and burn incense unto Baal, and walk after other gods whom ye know not;
Jeremiah 7:10	And come and stand before me in this house, which is called by my name, and say, We are delivered to do all these abominations?
Jeremiah 7:11	Is this house, which is called by my name, become a den of robbers in your eyes? Behold, even I have seen it, saith the LORD.
Jeremiah 7:12	But go ye now unto my place which was in Shiloh, where I set my name at the first, and see what I did to it for the wickedness of my people Israel.
Jeremiah 7:13	And now, because ye have done all these works, saith the LORD, and I spake unto you, rising up early and speaking, but ye heard not; and I called you, but ye answered not;
Jeremiah 7:14	Therefore will I do unto this house, which is called by my name, wherein ye trust, and unto the place which I gave to you and to your fathers, as I have done to Shiloh.
Jeremiah 7:15	And I will cast you out of my sight, as I have cast out all your brethren, even the whole seed of Ephraim.
Jeremiah 7:16	Therefore pray not thou for this people, neither lift up cry nor prayer for them, neither make intercession to me: for I will not hear thee.
Jeremiah 7:17	Seest thou not what they do in the cities of Judah and in the streets of Jerusalem?
Jeremiah 7:18	The children gather wood, and the fathers kindle the fire, and the women knead their dough, to make cakes to the queen of heaven, and to pour out drink offerings unto other gods, that they may provoke me to anger.
Jeremiah 7:19	Do they provoke me to anger? saith the LORD: do they not provoke themselves to the confusion of their own faces?
Jeremiah 7:20	Therefore thus saith the Lord GOD; Behold, mine anger and my fury shall be poured out upon this place, upon man, and upon beast, and upon the trees of the field, and upon the fruit of the ground; and it shall burn, and shall not be quenched.
Jeremiah 7:21	Thus saith the LORD of hosts, the God of Israel; Put your burnt offerings unto your sacrifices, and eat flesh.
Jeremiah 7:22	For I spake not unto your fathers, nor commanded them in the day that I brought them out of the land of Egypt, concerning burnt offerings or sacrifices:
Jeremiah 7:23	But this thing commanded I them, saying, Obey my voice, and I will be your God, and ye shall be my people: and walk ye in all the ways that I have commanded you, that it may be well unto you.
Jeremiah 7:24	But they hearkened not, nor inclined their ear, but walked in the counsels and in the imagination of their evil heart, and went backward, and not forward.
Jeremiah 7:25	Since the day that your fathers came forth out of the land of Egypt unto this day I have even sent unto you all my servants the prophets, daily rising up early and sending them:
Jeremiah 7:26	Yet they hearkened not unto me, nor inclined their ear, but hardened their neck: they did worse than their fathers.
Jeremiah 7:27	Therefore thou shalt speak all these words unto them; but they will not hearken to thee: thou shalt also call unto them; but they will not answer thee.
Jeremiah 7:28	But thou shalt say unto them, This is a nation that obeyeth not the voice of the LORD their God, nor receiveth correction: truth is perished, and is cut off from their mouth.
Jeremiah 7:29	Cut off thine hair, O Jerusalem, and cast it away, and take up a lamentation on high places; for the LORD hath rejected and forsaken the generation of his wrath.
Jeremiah 7:30	For the children of Judah have done evil in my sight, saith the LORD: they have set their abominations in the house which is called by my name, to pollute it.
Jeremiah 7:31	And they have built the high places of Tophet, which is in the valley of the son of Hinnom, to burn their sons and their daughters in the fire; which I commanded them not, neither came it into my heart.
