Jeremiah 7:32	Therefore, behold, the days come, saith the LORD, that it shall no more be called Tophet, nor the valley of the son of Hinnom, but the valley of slaughter: for they shall bury in Tophet, till there be no place.
Jeremiah 7:33	And the carcases of this people shall be meat for the fowls of the heaven, and for the beasts of the earth; and none shall fray them away.
Jeremiah 7:34	Then will I cause to cease from the cities of Judah, and from the streets of Jerusalem, the voice of mirth, and the voice of gladness, the voice of the bridegroom, and the voice of the bride: for the land shall be desolate.
Jeremiah 8:1	At that time, saith the LORD, they shall bring out the bones of the kings of Judah, and the bones of his princes, and the bones of the priests, and the bones of the prophets, and the bones of the inhabitants of Jerusalem, out of their graves:
Jeremiah 8:2	And they shall spread them before the sun, and the moon, and all the host of heaven, whom they have loved, and whom they have served, and after whom they have walked, and whom they have sought, and whom they have worshipped: they shall not be gathered, nor be buried; they shall be for dung upon the face of the earth.
Jeremiah 8:3	And death shall be chosen rather than life by all the residue of them that remain of this evil family, which remain in all the places whither I have driven them, saith the LORD of hosts.
Jeremiah 8:4	Moreover thou shalt say unto them, Thus saith the LORD; Shall they fall, and not arise? shall he turn away, and not return?
Jeremiah 8:5	Why then is this people of Jerusalem slidden back by a perpetual backsliding? they hold fast deceit, they refuse to return.
Jeremiah 8:6	I hearkened and heard, but they spake not aright: no man repented him of his wickedness, saying, What have I done? every one turned to his course, as the horse rusheth into the battle.
Jeremiah 8:7	Yea, the stork in the heaven knoweth her appointed times; and the turtle and the crane and the swallow observe the time of their coming; but my people know not the judgment of the LORD.
Jeremiah 8:8	How do ye say, We are wise, and the law of the LORD is with us? Lo, certainly in vain made he it; the pen of the scribes is in vain.
Jeremiah 8:9	The wise men are ashamed, they are dismayed and taken: lo, they have rejected the word of the LORD; and what wisdom is in them?
Jeremiah 8:10	Therefore will I give their wives unto others, and their fields to them that shall inherit them: for every one from the least even unto the greatest is given to covetousness, from the prophet even unto the priest every one dealeth falsely.
Jeremiah 8:11	For they have healed the hurt of the daughter of my people slightly, saying, Peace, peace; when there is no peace.
Jeremiah 8:12	Were they ashamed when they had committed abomination? nay, they were not at all ashamed, neither could they blush: therefore shall they fall among them that fall: in the time of their visitation they shall be cast down, saith the LORD.
Jeremiah 8:13	I will surely consume them, saith the LORD: there shall be no grapes on the vine, nor figs on the fig tree, and the leaf shall fade; and the things that I have given them shall pass away from them.
Jeremiah 8:14	Why do we sit still? assemble yourselves, and let us enter into the defenced cities, and let us be silent there: for the LORD our God hath put us to silence, and given us water of gall to drink, because we have sinned against the LORD.
Jeremiah 8:15	We looked for peace, but no good came; and for a time of health, and behold trouble!
Jeremiah 8:16	The snorting of his horses was heard from Dan: the whole land trembled at the sound of the neighing of his strong ones; for they are come, and have devoured the land, and all that is in it; the city, and those that dwell therein.
Jeremiah 8:17	For, behold, I will send serpents, cockatrices, among you, which will not be charmed, and they shall bite you, saith the LORD.
Jeremiah 8:18	When I would comfort myself against sorrow, my heart is faint in me.
Jeremiah 8:19	Behold the voice of the cry of the daughter of my people because of them that dwell in a far country: Is not the LORD in Zion? is not her king in her? Why have they provoked me to anger with their graven images, and with strange vanities?
Jeremiah 8:20	The harvest is past, the summer is ended, and we are not saved.
Jeremiah 8:21	For the hurt of the daughter of my people am I hurt; I am black; astonishment hath taken hold on me.
Jeremiah 8:22	Is there no balm in Gilead; is there no physician there? why then is not the health of the daughter of my people recovered?
Jeremiah 9:1	Oh that my head were waters, and mine eyes a fountain of tears, that I might weep day and night for the slain of the daughter of my people!
Jeremiah 9:2	Oh that I had in the wilderness a lodging place of wayfaring men; that I might leave my people, and go from them! for they be all adulterers, an assembly of treacherous men.
Jeremiah 9:3	And they bend their tongues like their bow for lies: but they are not valiant for the truth upon the earth; for they proceed from evil to evil, and they know not me, saith the LORD.
Jeremiah 9:4	Take ye heed every one of his neighbour, and trust ye not in any brother: for every brother will utterly supplant, and every neighbour will walk with slanders.
Jeremiah 9:5	And they will deceive every one his neighbour, and will not speak the truth: they have taught their tongue to speak lies, and weary themselves to commit iniquity.
Jeremiah 9:6	Thine habitation is in the midst of deceit; through deceit they refuse to know me, saith the LORD.
Jeremiah 9:7	Therefore thus saith the LORD of hosts, Behold, I will melt them, and try them; for how shall I do for the daughter of my people?
Jeremiah 9:8	Their tongue is as an arrow shot out; it speaketh deceit: one speaketh peaceably to his neighbour with his mouth, but in heart he layeth his wait.
Jeremiah 9:9	Shall I not visit them for these things? saith the LORD: shall not my soul be avenged on such a nation as this?
Jeremiah 9:10	For the mountains will I take up a weeping and wailing, and for the habitations of the wilderness a lamentation, because they are burned up, so that none can pass through them; neither can men hear the voice of the cattle; both the fowl of the heavens and the beast are fled; they are gone.
Jeremiah 9:11	And I will make Jerusalem heaps, and a den of dragons; and I will make the cities of Judah desolate, without an inhabitant.
Jeremiah 9:12	Who is the wise man, that may understand this? and who is he to whom the mouth of the LORD hath spoken, that he may declare it, for what the land perisheth and is burned up like a wilderness, that none passeth through?
Jeremiah 9:13	And the LORD saith, Because they have forsaken my law which I set before them, and have not obeyed my voice, neither walked therein;
Jeremiah 9:14	But have walked after the imagination of their own heart, and after Baalim, which their fathers taught them:
Jeremiah 9:15	Therefore thus saith the LORD of hosts, the God of Israel; Behold, I will feed them, even this people, with wormwood, and give them water of gall to drink.
Jeremiah 9:16	I will scatter them also among the heathen, whom neither they nor their fathers have known: and I will send a sword after them, till I have consumed them.
Jeremiah 9:17	Thus saith the LORD of hosts, Consider ye, and call for the mourning women, that they may come; and send for cunning women, that they may come:
Jeremiah 9:18	And let them make haste, and take up a wailing for us, that our eyes may run down with tears, and our eyelids gush out with waters.
Jeremiah 9:19	For a voice of wailing is heard out of Zion, How are we spoiled! we are greatly confounded, because we have forsaken the land, because our dwellings have cast us out.
Jeremiah 9:20	Yet hear the word of the LORD, O ye women, and let your ear receive the word of his mouth, and teach your daughters wailing, and every one her neighbour lamentation.
Jeremiah 9:21	For death is come up into our windows, and is entered into our palaces, to cut off the children from without, and the young men from the streets.
Jeremiah 9:22	Speak, Thus saith the LORD, Even the carcases of men shall fall as dung upon the open field, and as the handful after the harvestman, and none shall gather them.
Jeremiah 9:23	Thus saith the LORD, Let not the wise man glory in his wisdom, neither let the mighty man glory in his might, let not the rich man glory in his riches:
Jeremiah 9:24	But let him that glorieth glory in this, that he understandeth and knoweth me, that I am the LORD which exercise lovingkindness, judgment, and righteousness, in the earth: for in these things I delight, saith the LORD.
Jeremiah 9:25	Behold, the days come, saith the LORD, that I will punish all them which are circumcised with the uncircumcised;
